..........
..........
..B......R
..G.......
.YCDCA....
..........
......A...
......FG..
..D.F.....
R...B..Y..