...........
......F.N.R
......Y.L..
.FYC.......
..O.....C..
.O.........
.L.......P.
.D..R..N...
.....D.V...
P......G..V
M.......M.G