CF.........
...C......R
...PF..B...
.N..R..M...
....P...YB.
.........G.
........V..
....Y.....A
...A..M..V.
...NG......
...........