..P............
.CV.........A.B
...............
...............
.......M.....R.
.........L.N...
..........L.F..
...............
P..............
Y..V..GY....A.F
..R........G...
...B.........MO
.....C..O......
...............
..............N