...............
.V...........P.
..Y.N...LBV....
...............
...............
........F......
...............
.............GD
.......M.......
........PNR...D
......C........
..........O....
.......C...RO..
.Y...........G.
...L..BMF......
