.....RN..
....BF...
.....VY..
...Y.....
.........
.BVF.....
.MA...MA.
......P.N
......R.P